##########
#A       #
#  ####  #
#     #  #
#  ###   #
#      B #
##########